       ####
    ####  #
    #     #
    #  #  #
###### # ##
#      # #
#   #  # #
#####$## ###
#@     #   #
###### # # #
     #    .#
     #######
Author: Ghislain MARTIN
Title: PAS DE PIEGE
Collection: MONDE 01
AuthorMail: sokoban@wanadoo.fr
AuthorPage: http://perso.wanadoo.fr/sokoban
Date: 2001-03-12
